20 26 5 21
3,3,3,3,3,3,3,3,3,3,3,3,3,3,3,3,3,3,3,3,3,3,3,3,3,3
3,3,3,3,3,3,3,3,3,3,3,3,3,3,3,3,3,3,3,3,3,3,3,3,3,3
3,3,3,3,3,3,3,3,3,3,3,3,3,3,3,3,3,3,3,3,3,3,3,3,3,3
3,3,3,12,3,3,3,3,3,3,3,3,3,3,3,3,3,3,3,3,3,3,3,3,3,3
3,3,27,3,3,12,3,3,3,3,3,3,3,3,3,3,3,3,3,3,3,3,3,3,3,3
3,70,3,42,3,3,3,3,3,3,3,3,3,3,3,3,3,3,3,3,3,3,3,3,3,3
3,3,3,3,3,3,27,3,3,3,3,3,3,3,3,3,3,3,3,3,3,3,3,3,3,3
3,3,3,3,42,3,42,3,42,42,3,3,3,3,3,3,3,3,3,3,3,3,3,12,3,3
3,3,3,3,3,3,3,3,3,3,42,12,3,3,3,3,3,3,3,42,3,3,3,3,3,3
3,3,3,42,3,3,3,3,3,3,3,42,42,3,3,27,42,3,3,3,12,3,42,3,3,3
3,3,3,42,3,3,3,3,3,3,3,3,3,42,3,42,3,3,3,3,3,3,27,3,3,3
3,3,12,3,3,3,3,3,3,3,3,3,3,3,3,3,3,3,3,3,3,3,3,42,3,3
3,3,3,42,3,3,12,3,3,3,3,3,3,3,3,3,3,3,3,3,3,3,3,42,3,3
3,3,3,3,3,3,3,3,3,3,3,3,3,3,3,3,3,3,3,3,3,3,42,3,3,3
3,3,3,3,3,42,3,3,3,3,3,3,27,3,3,3,3,3,3,3,3,3,3,3,3,3
3,3,3,3,3,42,3,3,3,3,3,3,3,12,3,3,3,3,3,3,3,42,12,3,3,3
3,3,3,3,42,12,3,3,3,3,3,3,3,3,3,3,3,12,3,3,3,3,3,69,3,3
3,3,3,27,3,3,3,3,3,3,3,3,3,3,12,3,3,3,3,3,3,3,3,3,3,3
3,3,3,3,34,3,3,3,3,3,3,3,27,3,3,3,3,3,3,3,3,12,3,3,3,3
3,3,3,3,3,3,3,3,3,3,3,3,3,3,3,3,3,3,3,3,3,3,3,3,3,3
/////
119,119,119,119,119,119,119,119,119,119,119,119,119,119,119,119,119,119,119,119,119,119,119,119,119,119
119,119,119,119,119,119,119,119,119,119,119,119,119,119,119,119,119,119,119,119,119,119,119,119,119,119
119,119,31,32,32,32,33,119,119,119,119,119,119,119,119,119,119,119,119,119,119,119,119,119,119,119
119,31,49,0,0,0,48,119,119,119,119,119,119,119,119,119,119,119,119,119,119,119,119,119,119,119
119,46,0,0,0,0,48,119,119,119,119,119,119,119,119,119,119,119,119,119,119,119,119,119,119,119
119,46,69,0,0,0,50,32,32,32,32,32,33,119,119,119,119,119,119,119,119,119,119,119,119,119
119,46,0,0,0,0,0,0,0,0,0,0,48,119,119,119,119,31,32,32,33,119,31,32,33,119
119,46,0,0,0,0,0,0,0,0,0,0,48,119,119,119,119,46,0,0,50,19,49,0,48,119
119,46,0,0,0,0,0,0,0,0,0,0,50,32,32,32,32,49,0,0,0,34,0,0,48,119
119,46,0,0,0,0,0,0,0,0,0,0,0,0,0,0,0,0,0,0,0,0,0,0,48,119
119,46,0,0,0,0,0,0,0,0,0,0,0,0,0,0,0,0,0,0,0,0,0,0,48,119
119,46,0,0,0,0,0,0,0,0,0,0,0,0,0,0,0,0,0,0,0,0,0,0,48,119
119,46,0,0,0,0,0,0,0,0,0,0,0,0,0,0,0,0,0,0,0,0,0,0,48,119
119,46,0,0,0,0,0,0,0,0,0,0,0,0,0,0,0,0,0,0,0,0,0,0,48,119
119,46,0,0,0,0,0,0,0,0,0,0,0,0,0,0,0,0,0,0,0,0,0,65,63,119
119,46,0,0,0,0,65,62,62,62,62,64,0,0,0,0,0,0,0,0,0,0,0,48,119,119
119,46,0,0,0,0,48,119,119,119,119,46,0,0,0,0,0,0,0,0,0,0,70,48,119,119
119,46,0,0,35,0,48,119,119,119,119,46,0,0,0,0,0,0,0,0,0,0,0,50,33,119
119,61,62,62,62,62,63,119,119,119,119,46,0,0,36,0,0,0,0,0,0,0,0,0,48,119
119,119,119,119,119,119,119,119,119,119,119,61,62,62,62,62,62,62,62,62,62,62,62,62,63,119
/////
0,0,0,0,0,0,0,0,0,0,0,0,0,0,0,0,0,0,0,0,0,0,0,0,0,0
0,0,0,0,0,0,0,0,0,0,0,0,0,0,0,0,0,0,0,0,0,0,0,0,0,0
0,0,0,0,0,0,0,0,0,0,0,0,0,0,0,0,0,0,0,0,0,0,0,0,0,0
0,0,0,0,0,0,0,0,0,0,0,0,0,0,0,0,0,0,0,0,0,0,0,0,0,0
0,0,0,0,0,0,0,0,0,0,0,0,0,0,0,0,0,0,0,0,0,0,0,0,0,0
0,0,0,0,0,0,0,0,0,0,0,0,0,0,0,0,0,0,0,0,0,0,0,0,0,0
0,0,0,0,0,0,0,0,0,0,0,0,0,0,0,0,0,0,0,0,0,0,0,0,0,0
0,0,0,0,0,0,0,0,0,0,0,0,0,0,0,0,0,0,0,0,173,0,0,0,0,0
0,0,0,0,0,0,0,0,0,0,0,0,0,0,0,0,0,0,0,0,0,0,0,0,0,0
0,0,0,0,0,0,0,0,0,0,0,0,0,0,0,0,0,0,0,0,0,0,0,0,0,0
0,0,0,0,0,0,0,0,0,0,0,0,0,0,0,0,0,0,0,0,0,0,0,0,0,0
0,0,0,0,0,0,0,0,0,0,0,0,0,0,0,0,0,0,0,0,0,0,0,0,0,0
0,0,0,0,0,0,0,0,0,0,0,244,0,0,0,0,232,228,0,0,0,0,0,0,0,0
0,0,0,0,0,0,0,245,246,245,246,0,0,0,0,0,0,0,0,0,0,0,0,0,0,0
0,0,0,0,0,0,0,260,261,260,261,211,0,0,0,0,0,0,0,0,0,0,0,0,0,0
0,0,0,0,0,0,0,0,0,0,0,0,241,0,0,0,0,0,256,0,0,0,0,0,0,0
0,0,0,0,0,0,0,0,0,0,0,0,0,0,227,258,0,0,0,257,0,0,0,0,0,0
0,0,0,0,0,0,0,0,0,0,0,0,228,0,0,0,0,227,0,0,0,0,0,0,0,0
0,0,0,0,0,0,0,0,0,0,0,0,0,0,0,0,0,0,0,0,0,0,0,231,0,0
0,0,0,0,0,0,0,0,0,0,0,0,0,0,0,0,0,0,0,0,0,0,0,0,0,0
/////
0,0,0,0,0,0,0,0,0,0,0,0,0,0,0,0,0,0,0,0,0,0,0,0,0,0
0,0,0,0,0,0,0,0,0,0,0,0,0,0,0,0,0,0,0,0,0,0,0,0,0,0
0,0,0,0,71,0,0,0,0,0,0,0,0,0,0,0,0,0,0,0,0,0,0,0,0,0
0,0,0,0,0,0,0,0,0,0,0,0,0,0,0,0,0,0,0,0,0,0,0,0,0,0
0,0,0,0,0,0,0,0,0,0,0,0,0,0,0,0,0,0,0,0,0,0,0,0,0,0
0,0,0,0,0,0,0,272,0,0,0,0,0,0,0,0,0,0,0,0,0,0,0,0,0,0
0,0,0,0,0,0,0,287,0,0,0,0,0,0,0,0,0,0,51,0,0,0,0,0,0,0
0,0,0,0,0,0,0,0,0,0,0,0,0,0,0,0,0,0,66,212,0,0,0,39,0,0
0,0,0,0,0,0,0,0,0,0,51,0,0,0,272,0,0,0,0,0,259,0,0,0,0,0
0,0,0,0,0,0,0,0,0,0,66,0,0,0,287,0,0,0,0,0,0,0,0,0,0,0
0,0,0,0,0,0,0,0,0,0,0,0,0,0,0,0,0,0,0,0,0,0,0,0,0,0
0,0,0,0,0,0,0,0,0,0,0,0,0,0,0,0,0,0,0,0,0,0,0,0,0,0
0,0,0,0,0,0,0,0,0,0,0,0,0,0,0,0,0,0,0,0,0,0,0,272,0,0
0,0,0,0,0,0,0,0,0,0,0,0,0,0,0,0,0,0,0,0,0,0,0,287,0,0
0,0,0,0,0,0,0,0,0,259,0,0,0,0,0,0,0,0,0,0,0,0,0,0,0,0
0,0,0,272,0,0,0,0,0,0,0,0,0,0,0,0,0,0,0,0,0,0,0,0,0,0
0,0,0,287,0,0,0,0,0,0,0,0,0,0,0,0,0,0,259,0,0,0,0,0,0,0
0,0,0,0,0,0,0,0,0,0,0,0,0,0,183,168,183,0,0,0,0,0,0,0,0,0
0,0,0,0,0,0,0,0,0,0,0,0,0,0,0,0,0,0,0,0,0,0,0,0,0,0
0,0,0,0,0,0,0,0,0,0,0,0,0,0,0,0,0,0,0,0,0,0,0,0,0,0
/////
0,0,0,0,0,0,0,0,0,0,0,0,0,0,0,0,0,0,0,0,0,0,0,0,0,0
0,0,0,0,13,0,0,0,0,0,0,0,0,0,0,0,0,0,0,0,0,0,0,0,0,0
0,0,0,0,28,0,0,0,0,0,0,0,0,0,0,0,0,0,0,0,0,0,0,0,0,0
0,0,0,0,0,0,0,0,0,0,0,0,0,0,0,0,0,0,0,0,0,0,0,0,0,0
0,0,0,0,0,0,238,239,240,0,0,0,0,0,0,0,0,0,0,0,0,0,0,0,0,0
0,0,0,0,0,0,253,254,255,0,0,0,0,0,0,0,0,0,0,0,0,0,0,43,0,0
0,0,0,0,0,0,268,269,270,0,0,0,0,0,0,0,0,0,0,0,0,0,0,58,0,0
0,0,137,0,0,0,0,0,0,0,0,0,0,238,239,240,0,0,0,0,45,0,137,0,0,0
0,0,0,0,0,0,0,0,0,0,0,0,0,253,254,255,0,0,0,0,60,0,0,0,0,0
0,0,0,0,0,0,0,0,0,0,0,0,0,268,269,270,0,0,0,0,0,0,0,0,0,0
0,0,0,0,0,0,0,0,0,0,0,0,0,0,0,0,0,0,0,0,0,0,0,0,0,0
0,0,0,0,0,0,0,0,0,0,0,0,0,0,0,0,0,0,0,0,0,0,238,239,240,0
0,0,0,0,0,0,0,0,0,0,152,0,0,0,0,0,0,0,0,0,0,0,253,254,255,0
0,0,0,0,0,0,0,0,0,0,0,0,0,0,0,0,0,0,0,0,0,0,268,269,270,0
0,0,238,239,240,0,0,0,0,0,0,0,0,0,0,0,0,0,0,0,0,0,0,0,0,0
0,0,253,254,255,0,0,0,0,0,0,0,181,0,0,136,0,0,0,0,0,0,167,0,0,0
0,0,268,269,270,0,0,0,0,0,0,0,0,0,0,151,167,0,0,0,0,0,0,0,0,0
0,0,0,0,0,0,0,0,0,0,0,0,0,0,0,166,0,0,0,181,0,0,0,13,0,0
0,0,0,0,0,0,0,0,0,0,0,0,0,0,0,0,0,0,0,0,0,0,0,28,0,0
0,0,0,0,0,0,0,0,0,0,0,0,0,0,0,0,0,0,0,0,0,0,0,0,0,0
/////
