8 8 4 22
3,3,3,3,3,3,3,3
3,3,4,4,3,3,3,3
3,3,3,4,3,3,4,3
70,3,3,3,3,3,3,3
3,3,3,3,3,4,3,3
3,3,3,3,3,4,3,3
3,3,4,3,4,3,3,3
3,3,3,3,3,3,3,3
/////
31,32,32,32,32,32,32,33
46,0,0,0,0,0,0,48
46,0,0,0,0,0,0,48
46,69,0,0,0,0,0,48
46,47,0,0,0,0,0,48
46,0,0,0,0,0,0,48
46,0,0,0,0,0,0,48
61,62,62,62,62,62,62,63
/////
0,0,56,82,112,0,0,0
0,198,199,97,127,0,144,0
0,0,0,0,0,0,159,0
0,0,0,0,0,0,0,0
0,0,0,0,0,0,0,0
0,0,0,0,0,0,0,0
0,0,0,192,0,0,206,0
0,0,0,0,0,0,0,0
//////
0,167,0,0,0,137,0,0
0,0,0,0,0,0,0,0
0,0,0,0,0,0,136,0
0,0,0,0,0,0,151,0
0,0,0,0,0,0,166,0
0,0,182,0,0,0,0,0
0,0,0,0,0,0,0,0
0,0,0,0,0,0,0,0
/////
