8 15 6 18
3,4,4,4,4,4,3,4,4,4,3,3,3,3,3
3,4,4,4,4,4,4,4,3,4,4,4,4,4,3
3,4,4,4,3,4,3,4,4,4,4,4,4,4,3
3,4,4,4,4,3,4,4,3,4,4,4,4,4,3
3,4,4,3,4,3,4,3,4,3,4,4,4,4,3
3,4,4,4,4,4,4,4,4,4,4,4,4,4,4
3,3,4,4,4,4,4,4,4,4,4,4,4,4,4
3,3,3,3,3,4,4,4,4,34,3,3,3,3,3
//////
31,32,32,32,32,32,32,32,32,32,32,32,32,32,33
46,0,0,0,0,0,0,0,0,0,0,0,0,0,48
46,0,0,0,0,0,0,0,0,0,0,0,0,0,48
46,0,0,0,0,0,0,0,0,0,0,0,0,0,48
46,0,0,0,0,0,0,0,0,0,0,0,0,0,48
61,64,0,0,0,0,0,0,0,0,0,0,0,0,48
119,61,62,62,64,0,0,0,0,35,0,0,0,65,63
119,119,119,119,61,62,62,62,62,62,62,62,62,63,119
/////
0,209,209,209,0,20,0,116,20,117,117,20,118,0,0
0,209,209,224,0,0,0,0,0,0,0,0,0,0,0
0,224,224,0,0,0,0,0,36,36,36,36,36,36,0
0,0,0,0,0,0,0,0,200,200,0,0,200,200,0
0,0,0,0,0,0,0,0,0,0,0,0,0,0,0
0,0,0,0,0,0,0,0,135,0,135,0,0,0,0
0,0,0,0,0,0,0,0,150,0,150,0,0,0,0
0,0,0,0,0,0,0,0,0,0,0,0,0,0,0
//////
0,0,0,0,0,0,0,0,0,0,0,0,0,0,0
0,0,0,0,0,0,0,0,0,0,0,0,0,0,0
0,210,210,210,210,210,210,210,0,0,0,0,0,0,0
0,225,225,225,225,225,225,225,0,0,0,0,0,0,0
0,0,0,0,0,0,0,0,0,0,0,0,0,0,0
0,0,0,0,0,0,0,0,0,0,0,0,0,0,0
0,0,0,0,0,0,0,0,0,0,0,0,0,0,0
0,0,0,0,0,0,0,0,0,0,0,0,0,0,0
/////
0,0,0,0,0,0,0,0,0,0,0,0,0,0,0
0,0,0,0,0,0,0,0,0,0,0,0,0,0,0
0,0,0,37,38,0,0,0,0,0,0,0,0,0,0
0,0,0,52,53,0,0,0,0,0,0,0,0,0,0
0,0,0,67,68,0,0,0,0,0,0,0,0,0,0
0,0,0,0,0,0,0,0,0,0,0,0,0,0,0
0,0,0,0,0,0,0,0,0,0,0,0,0,0,0
0,0,0,0,0,0,0,0,0,0,0,0,0,0,0
/////
0,0,0,0,167,0,0,0,0,0,0,0,0,136,0
0,0,0,0,0,0,0,0,0,0,137,0,0,151,0
0,0,0,152,152,0,0,0,0,0,0,0,0,166,0
0,0,0,0,0,0,0,0,0,0,0,0,0,0,0
0,0,0,0,0,0,0,0,0,0,0,0,0,0,0
0,0,0,0,0,0,0,0,0,0,0,0,0,182,0
0,0,0,0,0,0,0,181,0,0,0,0,0,0,0
0,0,0,0,0,0,0,0,0,0,0,0,0,0,0
