30 50 4 19
3,3,3,3,3,3,3,3,3,3,3,3,3,3,3,3,3,3,3,3,3,3,3,3,3,3,3,3,3,3,3,3,3,12,3,3,3,3,3,3,3,3,3,3,3,3,3,3,3,3
3,3,3,3,3,3,3,3,3,3,3,3,3,3,3,3,3,3,3,3,3,3,3,3,3,3,3,3,3,3,3,3,3,3,3,3,3,3,3,3,12,3,3,3,3,3,12,3,3,3
3,3,3,3,3,3,3,3,3,3,3,3,3,3,3,3,3,3,3,12,3,3,3,3,3,3,3,3,3,3,12,3,3,3,12,3,3,12,3,3,3,3,3,3,3,3,3,3,12,3
3,3,3,3,3,3,3,3,3,3,3,12,3,3,3,12,3,3,3,3,3,3,3,3,3,3,3,3,42,42,3,12,42,3,3,3,3,3,3,12,3,3,3,3,3,3,3,3,3,3
3,3,3,3,3,3,3,3,3,3,3,42,3,3,3,3,3,3,3,3,3,3,3,3,3,3,3,3,3,3,3,3,3,3,3,3,42,3,3,3,3,12,3,3,3,3,3,12,3,3
3,3,3,3,3,3,3,3,3,3,3,3,3,3,3,3,3,3,3,3,3,3,3,3,3,42,42,12,3,3,3,3,3,3,3,3,3,3,3,3,42,3,3,3,3,12,3,3,3,3
3,3,12,3,3,3,3,12,3,3,42,3,3,3,3,3,3,3,3,12,3,3,3,3,42,3,3,3,3,3,3,3,3,12,3,3,3,3,3,3,3,3,3,3,3,3,3,3,3,3
3,3,3,3,3,3,3,3,3,42,3,3,12,3,3,3,3,3,3,3,3,3,3,12,3,3,3,3,3,3,3,3,3,3,3,3,3,3,3,3,3,3,42,3,3,3,3,12,3,3
3,3,3,3,3,3,3,3,12,3,3,3,3,3,3,3,3,3,3,3,3,3,3,42,3,3,3,3,3,3,12,3,3,3,3,3,12,3,3,12,3,3,3,3,3,3,3,3,3,3
3,3,3,3,3,3,3,3,3,3,3,3,3,3,3,3,3,3,3,12,3,3,3,3,3,3,3,3,3,3,3,3,3,3,3,3,3,3,3,3,3,3,3,42,3,3,3,3,3,3
3,3,3,3,3,3,3,3,3,42,3,3,3,3,3,12,3,3,3,3,3,3,3,3,3,3,3,3,3,3,12,3,3,3,3,3,3,3,3,3,12,3,12,3,3,3,3,3,3,3
3,3,3,3,3,12,3,3,3,3,42,3,3,3,3,3,3,3,3,3,3,3,3,3,3,12,3,3,3,3,3,3,3,3,3,3,12,3,3,3,3,3,3,3,3,12,3,3,3,3
3,3,3,3,3,3,3,3,3,3,3,3,3,3,3,3,3,3,3,3,3,3,3,3,3,3,3,3,3,3,3,3,3,3,3,3,3,3,3,3,3,3,3,3,3,3,3,3,3,3
3,3,3,3,3,3,3,3,3,3,42,12,3,3,3,3,3,3,3,3,3,12,3,3,3,3,3,3,3,3,3,3,3,3,3,3,3,3,3,3,3,3,3,3,3,3,3,3,3,3
3,3,3,12,3,3,3,3,3,3,3,3,3,3,3,3,3,3,3,42,3,3,3,3,3,3,3,3,3,3,3,3,12,42,42,3,3,3,3,3,3,3,42,42,3,3,12,3,3,3
3,3,3,3,3,3,42,42,42,3,3,3,42,3,42,3,42,3,3,3,3,3,42,3,3,3,3,12,42,42,42,3,3,3,3,3,42,3,42,42,3,3,3,3,3,42,3,3,42,3
3,3,3,3,3,3,3,12,3,3,3,3,3,3,3,3,12,3,3,3,3,12,3,3,42,3,3,3,3,3,3,3,3,3,3,3,3,3,3,3,3,3,3,3,3,3,3,3,3,3
3,3,3,3,3,3,3,3,3,3,3,3,3,3,3,3,3,3,12,3,3,3,3,3,3,3,3,3,3,3,3,3,3,3,3,3,12,3,3,3,3,3,3,12,3,3,3,3,3,3
3,3,3,3,3,3,3,3,42,3,3,3,3,3,3,3,3,3,3,3,3,3,3,3,12,42,3,3,3,3,3,3,12,3,3,3,3,3,3,3,3,3,3,3,3,3,3,3,3,3
12,3,3,3,3,3,3,3,3,3,3,12,3,3,3,3,3,3,3,3,3,3,3,3,3,3,42,42,3,3,3,3,3,3,3,3,3,3,3,12,3,3,3,3,3,12,12,3,3,3
12,3,3,3,3,3,3,3,3,42,3,3,3,3,12,3,3,3,3,3,3,3,12,3,42,42,3,12,3,3,3,3,3,3,3,3,3,3,3,3,3,3,3,3,3,3,3,3,3,3
3,3,3,3,3,3,3,3,12,3,3,3,3,3,3,3,3,3,12,3,3,3,3,42,42,3,3,3,3,3,3,3,3,3,3,12,3,3,3,3,3,3,3,3,3,3,3,3,12,3
3,3,3,3,3,3,3,3,42,3,3,3,3,3,3,3,3,3,3,3,3,3,42,3,12,3,3,3,42,3,3,42,3,12,3,3,3,3,3,3,3,3,3,3,3,3,3,3,3,3
3,3,3,3,3,3,3,3,3,42,3,3,3,3,3,3,12,3,42,12,42,42,3,3,3,3,3,12,3,3,12,3,3,3,3,3,3,3,3,3,3,3,3,3,12,3,3,3,3,3
3,3,3,3,3,3,3,3,12,12,3,3,3,3,3,3,3,3,3,3,3,3,12,3,3,3,3,3,3,3,3,3,42,3,3,3,3,3,12,3,3,3,3,3,3,3,3,3,3,3
3,3,3,3,3,3,3,3,3,3,42,3,42,3,3,3,42,3,3,3,3,3,3,3,3,3,3,3,3,3,3,3,3,42,42,3,3,3,3,3,3,3,3,3,3,3,3,3,3,3
3,3,3,12,3,3,3,3,3,3,3,3,3,3,3,12,3,3,3,3,3,3,3,3,3,3,3,12,3,3,3,3,3,3,3,3,3,3,3,12,3,3,3,3,3,3,3,3,3,3
3,3,3,3,3,3,3,3,3,3,3,3,3,3,3,3,3,3,3,3,3,12,3,3,3,3,3,3,3,3,3,3,3,3,3,3,3,3,3,3,3,12,3,3,3,12,3,3,3,3
3,3,12,3,3,3,3,3,3,12,3,3,3,3,3,12,3,3,3,3,3,3,12,3,3,3,12,3,3,3,3,12,3,3,3,3,3,3,3,3,3,3,3,3,3,3,3,3,3,3
3,3,3,3,3,3,3,3,3,3,3,3,3,3,3,3,3,3,3,3,3,3,3,3,3,3,3,3,3,3,3,3,3,3,3,3,3,3,3,3,3,3,3,3,3,3,3,3,3,3
//////
119,119,119,119,31,32,32,32,32,32,32,32,32,32,32,32,33,119,119,119,119,119,119,119,119,119,119,119,119,119,119,119,31,32,32,32,32,32,32,32,32,32,32,32,32,32,32,32,32,32
119,119,119,31,49,0,0,0,0,0,0,0,0,0,0,0,48,119,119,119,119,119,119,119,119,119,119,31,32,32,32,32,49,0,0,0,0,0,0,0,0,0,0,0,0,0,0,0,0,0
119,119,31,49,0,0,0,0,0,0,0,0,0,0,0,0,50,32,33,119,119,119,119,31,32,32,32,49,0,0,0,0,0,0,0,0,0,0,0,0,0,0,0,0,0,0,0,0,0,0
31,32,49,0,0,0,0,0,0,0,0,0,0,0,0,0,0,0,50,33,119,31,32,49,0,0,0,0,0,0,0,0,0,0,0,0,0,0,0,0,0,0,0,0,0,0,0,0,0,0
46,0,0,0,0,0,0,0,0,0,0,0,0,0,0,0,0,0,0,50,32,49,0,0,0,0,0,0,0,0,0,0,0,0,0,0,0,0,0,0,0,0,0,0,0,0,0,0,0,0
46,0,0,0,0,0,0,0,0,0,0,0,0,0,0,0,0,0,0,0,0,0,0,0,0,0,0,0,0,65,62,62,62,62,62,64,0,0,0,0,0,0,0,0,0,0,0,0,0,0
46,0,0,0,0,0,0,0,0,0,0,0,0,0,0,0,0,0,0,0,0,0,0,0,0,0,0,0,65,63,119,119,119,119,119,46,0,0,0,0,0,0,0,0,0,0,0,0,0,0
46,0,0,0,0,0,0,0,0,0,0,0,0,0,0,0,0,0,0,0,0,0,0,0,0,0,0,65,63,119,119,119,119,119,119,61,64,0,0,0,0,0,0,0,0,0,0,0,0,0
46,0,0,0,0,0,0,0,0,0,0,0,0,0,0,0,0,0,0,0,0,0,0,0,0,0,0,48,119,119,119,119,119,119,119,119,46,0,0,0,0,0,0,0,0,0,0,0,0,0
46,0,0,0,0,0,0,0,0,0,0,0,0,0,0,0,0,0,0,0,0,0,0,0,0,0,0,50,33,119,119,119,119,119,31,32,49,0,0,0,0,0,0,0,0,0,0,0,0,0
61,64,0,0,0,0,0,0,0,0,0,0,0,0,0,0,0,0,0,0,0,0,0,0,0,0,0,0,48,119,119,119,119,119,46,0,0,0,0,0,0,0,0,0,0,0,0,0,0,0
119,46,0,0,0,0,0,0,0,0,0,0,0,0,0,0,0,0,0,0,0,0,0,0,0,0,0,0,50,32,33,119,31,32,49,0,0,0,0,0,0,0,0,0,0,0,0,0,0,0
119,119,64,0,0,0,0,0,0,0,0,0,0,0,0,0,0,0,0,0,0,0,0,0,0,0,0,0,0,0,48,119,46,0,0,0,0,0,0,0,0,0,0,0,0,0,0,0,0,0
119,119,61,64,0,0,0,0,0,0,0,0,0,0,0,0,0,0,0,0,0,0,0,0,0,0,0,0,0,0,50,32,49,0,0,0,0,0,0,0,0,0,0,0,0,0,0,0,0,0
119,119,119,61,64,0,0,0,0,0,0,0,0,0,0,0,0,0,0,0,0,0,0,0,0,0,0,0,0,0,0,0,0,0,0,0,0,0,0,0,0,0,0,0,0,0,0,0,0,0
119,119,119,119,46,69,0,0,0,0,0,0,0,0,0,0,0,0,0,0,0,0,0,0,0,0,0,0,0,0,0,0,0,0,0,0,0,0,0,0,0,0,0,0,0,0,0,0,0,0
119,119,119,31,49,0,0,0,0,0,0,0,0,0,0,0,65,62,64,0,0,0,0,0,0,0,0,0,0,0,0,0,0,0,0,0,0,0,0,0,0,0,0,0,0,0,0,0,0,0
119,31,32,49,0,0,0,0,0,0,0,0,0,0,0,65,63,119,61,64,0,0,0,0,0,0,0,0,0,0,0,0,0,0,0,0,0,0,0,0,0,0,0,0,0,0,0,0,0,0
31,49,0,0,0,0,0,0,0,0,0,0,0,0,65,63,119,119,119,46,0,0,0,0,0,0,0,0,0,0,0,0,0,0,0,0,0,0,0,0,0,0,0,0,0,0,0,0,0,0
46,0,0,0,0,0,0,0,0,0,0,0,0,0,48,119,119,119,31,49,0,0,0,0,0,0,0,0,0,0,0,0,0,0,0,0,0,0,0,0,0,0,0,0,0,0,0,0,0,0
46,0,0,0,0,0,0,0,0,0,0,0,0,0,50,32,32,32,49,0,0,0,0,0,0,0,0,0,0,0,0,0,0,0,0,0,0,65,62,64,0,0,0,0,0,0,0,0,0,0
46,0,0,0,0,0,0,0,0,0,0,0,0,0,0,0,0,0,0,0,0,0,0,0,0,0,0,0,0,0,0,0,0,0,65,62,62,63,119,61,64,0,0,65,62,64,0,0,0,0
46,0,0,0,0,0,0,0,0,0,0,0,0,0,0,0,0,0,0,0,0,0,0,0,0,0,0,0,0,0,0,0,0,65,63,119,119,119,119,119,61,62,62,63,119,119,64,0,0,0
46,0,0,0,0,0,0,0,0,0,0,0,0,0,0,0,0,0,0,0,0,0,0,0,0,0,0,0,0,0,0,0,0,50,33,119,119,119,119,119,119,119,119,119,119,119,61,64,0,0
46,0,0,0,0,0,0,0,0,0,0,0,0,0,0,0,0,0,0,0,0,0,0,0,0,0,0,0,0,0,0,0,0,0,50,32,32,32,33,119,119,119,119,119,119,119,119,46,0,0
46,0,0,0,0,0,0,0,0,0,0,0,0,0,0,0,0,0,0,0,0,0,0,0,0,0,65,62,62,64,0,0,0,0,0,0,0,0,50,32,32,33,119,119,119,119,119,46,0,0
61,62,64,0,0,0,0,0,0,0,0,0,0,0,0,0,0,0,0,0,0,0,65,62,62,62,63,119,119,61,64,0,0,0,0,0,0,0,0,0,0,50,33,119,119,119,119,61,64,0
119,119,61,64,0,0,0,0,0,0,0,0,0,0,0,0,0,0,0,0,65,62,63,119,119,119,119,119,119,119,61,62,62,64,0,0,0,0,0,0,0,0,50,33,119,119,119,119,46,0
119,119,119,119,62,62,62,62,64,0,0,0,0,0,0,0,0,0,0,65,63,119,119,119,119,119,119,119,119,119,119,119,119,61,62,64,0,0,0,0,0,0,0,48,119,119,119,119,61,64
119,119,119,119,119,119,119,119,61,62,62,62,62,62,62,62,62,62,62,63,119,119,119,119,119,119,119,119,119,119,119,119,119,119,119,61,62,62,62,62,62,62,62,48,119,119,119,119,119,61
///////
0,0,0,0,0,0,0,0,0,0,0,0,0,0,0,0,0,0,0,0,0,0,0,0,0,0,0,0,0,0,0,0,0,0,0,0,0,0,0,0,0,71,0,0,0,0,0,0,0,0
0,0,0,0,0,0,0,0,0,0,0,0,0,0,0,0,0,0,0,0,0,0,0,0,0,0,0,0,0,0,0,0,0,0,0,0,0,271,0,8,0,271,0,0,0,0,0,0,0,0
0,0,0,0,0,0,0,0,0,0,178,179,0,0,0,0,0,0,0,0,0,0,0,0,0,0,0,0,0,0,0,0,0,0,0,0,0,286,230,23,230,286,226,0,0,0,0,0,0,0
0,0,0,0,0,0,0,0,0,271,193,194,0,178,179,0,0,0,0,0,0,0,0,0,0,0,0,0,0,0,0,0,0,0,0,0,226,0,0,230,0,0,230,0,0,0,0,0,0,0
0,0,0,0,0,271,0,0,162,286,0,0,143,193,194,0,0,0,0,0,0,0,0,0,0,0,0,0,0,0,0,0,0,0,0,0,0,0,0,226,0,0,0,288,0,0,0,0,0,0
0,0,0,0,0,286,177,0,0,176,143,0,158,0,176,0,0,0,0,0,0,0,0,0,0,0,0,0,0,0,0,0,0,0,0,0,0,288,0,0,0,226,0,0,0,0,0,0,0,0
0,0,148,0,164,148,164,0,0,164,158,0,0,0,164,0,0,0,0,0,0,0,0,0,0,0,0,0,0,0,0,0,0,0,0,0,0,0,0,0,0,0,0,0,0,0,0,0,0,0
0,0,0,0,0,0,0,0,0,0,0,0,0,0,213,148,0,0,0,0,0,0,0,0,0,0,0,0,0,0,0,0,0,0,0,0,0,0,226,0,0,0,0,288,0,0,0,0,0,0
0,0,0,164,177,0,0,177,0,0,226,0,0,148,271,0,0,0,0,0,0,0,0,0,0,0,0,0,0,0,0,0,0,0,0,0,0,0,230,0,288,0,226,0,0,0,0,0,0,0
0,0,0,0,0,0,0,0,0,0,0,0,226,0,286,0,0,0,0,0,0,0,0,0,0,0,0,0,0,0,0,0,0,0,0,0,71,0,0,0,0,0,0,0,0,0,0,0,0,0
0,0,0,0,0,0,0,0,0,0,165,0,0,0,0,165,0,0,0,0,0,0,0,0,0,0,0,0,0,0,0,0,0,0,0,0,0,0,0,0,0,0,0,0,0,0,0,0,0,0
0,0,0,0,0,164,177,0,0,0,0,0,0,0,0,0,0,0,0,0,0,0,0,0,0,0,0,0,0,0,0,0,0,0,0,0,0,0,0,0,0,0,0,0,0,0,0,0,0,0
0,0,0,0,0,0,0,0,0,0,0,0,0,0,0,0,0,0,0,0,0,0,0,0,0,0,0,0,0,0,0,0,0,0,0,0,0,0,0,0,0,0,0,0,0,0,0,0,0,0
0,0,0,0,0,0,0,0,0,0,0,0,0,0,0,0,0,0,0,0,0,0,0,0,0,0,0,0,0,0,0,0,0,0,0,271,0,0,0,0,0,0,0,0,0,0,0,0,0,0
0,0,0,0,0,0,0,0,0,0,0,0,0,0,0,0,0,0,0,0,0,0,0,0,0,0,0,0,0,0,0,0,0,0,0,0,0,0,0,0,0,0,0,0,0,0,0,0,0,0
0,0,0,0,0,0,0,0,0,0,0,0,0,0,0,0,0,0,0,0,0,0,0,0,0,0,0,0,0,0,0,0,0,0,0,0,0,0,0,0,0,0,0,0,0,0,271,0,0,0
0,0,0,0,0,0,0,0,0,0,0,0,0,0,0,0,0,0,0,0,0,0,0,0,0,0,0,0,0,0,0,0,0,0,0,0,0,0,0,0,0,0,0,0,0,0,0,0,0,0
0,0,0,271,0,0,0,0,0,271,0,0,0,0,0,0,0,0,0,0,0,0,0,0,0,0,0,0,0,0,0,0,0,0,0,0,0,0,0,0,0,0,0,0,0,0,0,0,0,0
0,0,0,286,242,0,0,0,242,286,0,0,0,0,0,0,0,0,0,0,0,0,0,0,0,0,0,0,0,0,0,0,0,0,0,0,0,0,0,0,0,0,0,0,0,0,0,0,0,0
0,0,0,0,242,0,242,0,242,0,0,0,0,0,0,0,0,0,0,0,0,0,0,0,0,0,0,0,0,0,0,0,0,0,0,0,0,0,0,0,0,0,0,0,0,0,0,0,0,0
0,0,0,0,242,0,242,0,0,0,0,0,0,0,0,0,0,0,0,0,0,0,0,0,0,0,0,0,0,0,0,149,0,0,0,0,0,0,0,0,0,0,0,0,0,0,0,0,0,0
0,0,0,0,0,0,242,0,242,0,0,0,0,0,0,0,0,0,0,0,0,0,0,0,0,0,0,0,0,0,134,0,0,0,0,0,0,0,0,0,0,0,0,0,0,0,0,0,0,0
0,0,0,0,242,0,0,0,242,0,0,0,0,0,0,0,0,0,0,0,0,0,0,0,0,0,0,0,0,149,208,209,209,0,0,0,0,0,0,0,0,0,0,0,0,0,0,0,0,0
0,0,0,271,0,0,242,0,0,271,0,0,0,0,0,0,0,0,0,0,0,0,0,0,0,0,148,147,0,0,223,224,224,5,0,0,0,0,0,0,0,0,0,0,0,0,0,0,0,0
0,0,0,286,242,0,0,0,242,286,0,0,0,0,0,0,0,0,0,0,0,0,0,0,0,0,164,221,273,0,0,0,0,0,116,117,178,179,0,0,0,0,0,0,0,0,0,0,0,0
0,206,206,0,0,0,0,0,0,0,0,0,0,0,0,0,0,0,0,0,0,0,0,0,0,0,0,0,0,0,0,0,0,0,0,0,193,194,0,178,179,0,0,0,0,0,0,0,0,0
0,0,0,206,0,0,0,0,0,0,0,0,0,0,0,0,0,0,0,0,0,0,0,0,0,0,0,0,0,0,0,0,273,0,271,0,0,0,206,193,194,0,0,0,0,0,0,0,0,0
0,0,0,0,206,206,0,0,0,0,0,0,0,0,0,0,0,0,0,0,0,0,0,0,0,0,0,0,0,0,0,0,0,0,286,0,183,0,0,0,0,206,0,0,0,0,0,0,0,0
0,0,0,61,0,0,0,0,0,0,0,0,0,0,0,0,0,0,0,0,0,0,0,0,0,0,0,0,0,0,0,0,0,0,0,0,168,183,0,273,0,0,230,0,0,0,0,0,0,62
0,0,0,0,0,0,0,0,0,0,0,0,0,0,0,0,0,0,0,0,0,0,0,0,0,0,0,0,0,0,0,0,0,0,0,0,0,0,0,0,0,0,0,63,0,0,0,0,0,119
///////
0,0,0,0,0,0,180,0,0,0,0,0,0,0,180,0,0,0,0,0,0,0,0,0,0,0,0,0,0,0,0,0,0,0,0,0,238,239,240,0,238,239,240,0,0,0,0,0,0,0
0,0,0,0,0,0,0,0,0,0,0,0,0,0,0,0,0,0,0,0,0,0,0,0,0,0,0,0,0,0,0,0,0,0,0,0,253,254,255,151,253,254,255,0,0,0,0,0,0,0
0,0,0,0,0,0,0,0,238,239,240,0,0,0,0,0,0,0,0,0,0,0,0,0,0,180,0,0,0,0,0,0,0,0,0,0,0,0,0,166,0,0,0,0,0,0,0,0,0,0
0,0,0,0,238,239,240,0,253,254,255,0,0,180,0,0,0,0,0,0,0,0,0,0,0,0,0,0,0,0,227,0,0,0,0,0,0,0,0,0,0,0,0,0,0,0,0,0,0,0
0,0,0,0,253,254,255,0,0,0,0,0,0,195,0,0,0,0,0,0,0,0,0,0,0,0,0,0,0,0,0,0,0,0,0,0,0,0,0,0,0,0,0,0,0,0,0,0,0,0
0,0,0,0,0,0,0,0,0,180,0,0,0,0,180,0,0,0,0,0,0,0,0,0,0,0,0,0,0,0,0,0,0,0,0,0,0,0,0,0,0,0,0,0,0,0,0,0,0,0
0,0,0,0,0,0,0,0,0,195,0,0,0,0,195,0,0,0,0,0,227,247,0,0,0,0,0,0,0,0,0,0,0,0,0,0,0,0,0,0,0,0,0,0,0,0,0,0,0,0
0,0,0,0,0,0,0,0,0,0,0,0,0,238,239,240,0,0,0,0,0,0,0,0,0,0,0,0,0,0,0,0,0,0,0,0,0,0,151,0,0,0,0,0,0,0,0,0,0,0
0,0,0,0,0,0,0,0,0,0,0,0,0,253,254,255,0,0,0,0,0,0,0,0,0,227,227,0,0,0,0,0,0,0,0,0,0,0,166,0,0,0,0,0,0,0,0,0,0,0
0,0,0,0,0,0,0,0,0,0,0,0,0,0,0,0,0,0,0,0,0,0,0,0,0,0,0,0,0,0,0,0,0,0,0,0,72,0,0,0,0,0,0,0,0,0,0,247,0,0
0,0,0,0,0,0,0,0,0,0,0,0,0,0,0,0,0,0,0,0,0,0,0,0,0,0,0,0,0,0,0,0,0,0,0,0,0,0,0,0,0,0,0,0,0,0,0,0,0,0
0,0,0,0,0,0,0,0,0,0,0,0,0,0,0,0,0,0,0,0,0,0,0,183,0,0,0,0,0,0,0,0,0,0,180,0,0,0,0,0,0,0,0,0,0,0,0,0,0,0
0,0,0,0,0,0,0,0,0,0,0,0,0,0,0,0,0,0,0,0,0,0,183,168,149,0,0,0,0,0,0,0,0,0,238,239,240,0,0,0,0,0,0,0,0,0,247,0,0,0
0,0,0,0,0,0,0,0,0,0,0,0,0,0,247,0,227,0,0,0,0,0,0,0,0,0,0,0,227,0,0,180,0,0,253,254,255,0,0,0,0,0,0,0,0,0,0,0,0,0
0,0,0,0,0,0,0,0,0,0,0,0,0,0,0,0,0,0,0,0,0,0,0,0,0,0,0,0,0,0,0,0,0,0,0,286,0,0,0,0,0,0,0,0,0,238,239,240,0,0
0,0,0,0,0,0,0,0,0,0,0,0,0,0,0,0,0,0,0,0,0,0,0,0,0,0,0,0,0,0,0,0,247,0,0,0,0,0,0,0,0,0,0,0,0,253,254,255,0,0
0,0,238,239,240,0,0,0,238,239,240,0,0,0,0,0,0,0,0,0,0,0,0,0,0,0,0,0,0,0,0,0,0,0,0,0,0,0,0,0,0,0,0,0,0,0,286,0,0,0
0,0,253,254,255,0,0,0,253,254,255,0,0,247,0,0,0,0,0,0,0,0,0,0,0,0,227,0,0,0,0,0,0,0,247,0,0,0,0,227,0,0,0,0,0,0,0,0,0,0
0,0,0,0,0,0,0,0,0,0,0,0,0,0,0,0,0,0,0,0,0,0,0,0,0,0,0,0,0,0,0,0,0,0,0,0,0,0,0,0,0,0,0,0,0,0,0,0,0,0
0,0,0,0,0,0,0,0,0,0,0,0,0,0,0,0,0,0,0,0,0,0,0,0,0,0,0,0,0,0,0,0,0,0,227,0,0,0,0,0,0,0,0,0,0,227,0,0,0,0
0,0,0,0,0,0,0,0,0,0,0,0,0,0,0,0,0,0,227,0,0,0,247,0,0,0,0,0,0,0,0,0,0,0,0,0,0,0,0,0,0,0,0,0,0,0,0,0,0,0
0,0,0,0,0,0,0,0,0,0,0,0,0,227,0,0,0,0,0,0,0,0,0,0,0,0,0,0,0,0,0,0,0,0,0,0,0,0,0,0,0,0,0,0,0,0,0,0,0,0
0,0,238,239,240,0,0,0,238,239,240,0,0,0,0,0,0,0,0,0,0,0,0,227,0,0,0,0,0,0,0,0,0,0,0,0,0,0,0,0,0,0,0,0,0,0,0,0,0,0
0,0,253,254,255,0,0,0,253,254,255,0,0,0,0,0,0,0,0,0,0,0,0,0,0,0,0,0,0,0,0,0,0,0,0,0,0,0,0,0,0,0,0,0,0,0,0,0,0,0
0,0,0,0,0,0,0,0,0,0,0,0,0,0,0,0,0,0,0,0,0,0,0,0,0,0,247,0,0,0,0,0,0,0,0,0,0,0,0,0,0,0,0,0,0,0,0,0,0,0
0,0,0,151,0,0,0,0,0,0,0,0,0,0,0,247,0,0,0,0,0,0,0,0,0,0,0,0,0,0,0,0,0,238,239,240,0,0,0,0,0,0,0,0,0,0,0,0,0,0
0,0,0,166,0,0,0,0,0,0,0,0,0,0,0,0,0,0,227,0,0,0,0,0,0,0,0,0,0,0,0,0,0,253,254,255,0,0,0,0,0,0,0,0,0,0,0,0,0,0
0,0,0,0,0,0,0,0,0,0,227,0,0,0,0,0,0,0,0,0,0,0,0,0,0,0,0,0,0,0,0,0,0,0,0,0,0,0,0,0,0,0,151,0,0,0,0,0,0,0
0,0,0,0,0,0,0,0,0,0,0,0,0,0,0,0,0,0,0,0,0,0,0,0,0,0,0,0,0,0,0,0,0,0,0,0,0,0,0,0,0,0,166,0,0,0,0,0,0,0
0,0,0,0,0,0,0,0,0,0,0,0,0,0,0,0,0,0,0,0,0,0,0,0,0,0,0,0,0,0,0,0,0,0,0,0,0,0,0,0,0,0,0,0,0,0,0,0,0,0
///
